eee00eee
ee000eee
ee000eee
eee00eee
eee00eee
eee00eee
eee00eee
eee00eee
eee00eee
eee00eee
eee00eee
eee00eee
eee00eee
eee00eee
eee00eee
eee00eee
eee00eee
eee00eee
eee00eee
eee00eee
eee00eee
eee00eee
ee0000ee
ee0000ee
