eee3ee3e
eee3ee3e
eee3ee3e
eee3ee3e
ee33ee3e
ee33ee3e
ee3eee3e
ee3eee3e
e33eee3e
e33eee3e
e3eeee3e
e3eeee3e
33eeee3e
33eeee3e
3eeeee3e
3eeeee3e
3eeeee3e
33333333
33333333
eee33eee
eee33eee
eee33eee
eee33eee
eee33eee
