eee00eee
ee000eee
e0000eee
00e00eee
0ee00eee
eee00eee
eee00eee
eee00eee
eee00eee
eee00eee
eee00eee
eee00eee
eee00eee
eee00eee
eee00eee
eee00eee
eee00eee
eee00eee
eee00eee
eee00eee
eee00eee
eee00eee
00000000
00000000
