eee00eee
ee000eee
e0000eee
e0000eee
e0e00eee
eee00eee
eee00eee
eee00eee
eee00eee
eee00eee
eee00eee
eee00eee
eee00eee
eee00eee
eee00eee
eee00eee
eee00eee
eee00eee
eee00eee
eee00eee
eee00eee
eee00eee
e000000e
e000000e
