e9eee99e
99ee9999
99ee9999
e9ee9ee9
e9ee9ee9
e9ee9ee9
e9ee9ee9
e9ee9ee9
e9ee9ee9
e9ee9ee9
e9ee9ee9
e9ee9ee9
e9ee9ee9
e9ee9ee9
e9ee9ee9
e9ee9ee9
e9ee9ee9
e9ee9ee9
e9ee9ee9
e9ee9ee9
e9ee9ee9
e9ee9999
999e9999
999ee99e
